#################################################################################################
#################################################################################################
############################### ################################# ###############################
####                  &+                                                                     ####
#### ## ############# #### #### ########## ### ### ### ########## #### #### ############# ## ####
#### ##     $*                               #  #  #                                +*    ## ####
####   ### ### ########## # ####### #*######  # # #  ###### # ####### # ########## ### ###   ####
#### # ### #       #      # #       #   ##### # # # #####   #     &$# #      #$      # ### # ####
###  #     # ### # # #### # # # ##### # #     #   #     # # ##### # # # #### # # ### #     #  ###
#### # ##### # # # # *$#      # #   # # # ### ## ## ### # # #   # #      #   # # # # ##### # ####
#### # #     ### # # # # # ## # # #     # #   ## ##   # #     # # # ## # # # # # ###     # # ####
#### # # #####   # # # # # ## # # ####### # #### #### # ####### # # ## # # # # #   ##### # # ####
#### #       # #     #   #    #   #       # #### #### # *+    #   #    #   #     # #     & # ####
####   ##### # ##################   #####               #####   ################## # #####   ####
#### #     &$# #     #   # +& #   #       # #### #### #       #   # *$ #   #     # #       # ####
#### # # #####   # # # # # ## # # ####### # #### #### # ####### # # ## # # # # #   ##### # # ####
#### # #     ### # # # # # ## # # #     # #   ## ##   # #     # # # ## # # # # # ###     # # ####
#### # ##### # # # #   #      # #   # # # ### ## ## ### # # #   # #      #   # # # # ##### # ####
###  #     # ### # # #### # # # ##### # #     #   #     # # ##### # # # #### # # ### #     #  ###
#### # ### #       #      # #       #   ##### # # # #####$  #       # #      #       # ### # ####
####   ### ### ########## # ####### # ######  # # #  ###### # ####### # ########## ### ###   ####
#### ##    *$                                #  #  #            &+*                 +&    ## ####
#### ## ############# #### #### ########## ### ### ### ########## #### #### ############# ## ####
####                                     &                                                   ####
############################### ################################# ###############################
#################################################################################################
#################################################################################################