#################################################################################################
#################################################################################################
############################### ################################# ###############################
####                                                                                         ####
#### ## ############# ######### ########## ### ### ### ########## ######### ############# ## ####
#### ##                   #                  #  #  #   *$             #      $*$          ## ####
####    ## ### ########## # ####### # ######  # # #  ###### # ####### # ########## ### ##    ####
#### ##### #     *+#      # #       #   ##### # # # #####   #  +&   # #      #       # ##### ####
###      &$# ### # # #### # # # ##### # #     # # #     # # ##### # # # #### # # ### #  +&    ###
#### # ##### ### # # * #      # #   # # # ##### # ##### # # #   # # *    #   # # ### ##### # ####
#### # #     ### # # # # #### # # # # # # #           # # # # # # # #### # # # # ###     # # ####
#### # # #####   # # # # #### # # # # # # # # ## ## # # # # # # # # #### # # # #   ##### # # ####
#### #       # #     #   *$   #   #   &$#   # ## ## #   #     #   #        #     # #       # ####
#### ####### # #################### ####### #       # ####### #################### # ####### ####
#### #       # #*$   #    *$  #   #     #   # ## ## #   #     #   #  &$    #     # #       # ####
#### # # #####   # # # # #### # # # # # # # # ## ## # # # # # # # # #### # # # #   ##### # # ####
#### # #     ### # # # # #### # # # # # # #           # # # # # # # #### # # # # ###     # # ####
#### # ##### ### # #   #      # #   # # # ##### # ##### # # #   # #      #   # # ### ##### # ####
###        # ### # # #### # # # ##### # #     # # #     # # ##### # # # #### # # ### #        ###
#### ##### #       # *+   # #       #   ##### # # # #####   #     *+# #      #       # ##### ####
####    ## ### ########## # ####### # ######  # # #  ###### # ####### # ########## ### ##    ####
#### ##    &$             #      &+          #  #  #   *$             #         +*        ## ####
#### ## ############# ######### ########## ### ### ### ########## ######### ############# ## ####
####                                                                $&                       ####
############################### ################################# ###############################
#################################################################################################
#################################################################################################