#################################################################################################
#################################################################################################
############################### ################################# ###############################
####                  *+                       $*                                            ####
#### ########### ############## ########## ### ### ### ########## ############## ########### ####
#### ##        #          #         #        #  #  #     $& #         # *        #      & ## ####
#### #  ###### ########## # ####### # ######  # # #  ###### # ####### # ########## ######  # ####
#### # ###       #        # #   *$  #   ##### # # # #####   #       # #        #       ### # ####
###      *+##### # ###### # # # ##### # #     # # #     # # ##### # # # ###### # #####        ###
#### # #####     # #   #  #   # #+  # # # ##### # ##### # # #$  # #   #  #   # #$    ##### # ####
#### # #     ##### # # # #### # # # # # # ## ##   ## ## # # # # # # #### # # # #####     # # ####
#### # # ### #  $# # # # #### # # # # # # ###### ###### # # # # # # #### # # # #   # ### # # ####
#### #     #   #     #        #   #     #   #### ####   #+&   #   # *      #     #   #     # ####
#### ##### # ###################### #######           ####### ###################### # ##### ####
#### #     #   #     #   +*$  #   #     #   #### ####   #+&   #   #  +     #     #   #     # ####
#### # # ### #   # # # # #### # # # # # # ###### ###### # # # # # # #### # # # #+* # ### # # ####
#### # #     ##### # # # #### # # # # # #+## ##   ## ## # # # # # # #### # # # #####     # # ####
#### # #####     # #   #  #   # #   # # #&##### # ##### # # #   # #   #  #   # #     ##### # ####
###        ##### # ###### # # # ##### # #     # # #     # # ##### # # # ###### # #####        ###
#### # ###     &$#        # #   *$  #   ##### # # # #####   #  $    # #       $#       ### # ####
#### #  ###### ########## # ####### # ######  # # #  ###### # ####### # ########## ######  # ####
#### ##        #          #         #        #  #  #        #         # *+          &$    ## ####
#### ########### ############## ########## ### ### ### ########## ######### ################ ####
####                                    $&                                                   ####
############################### ################################# ###############################
#################################################################################################
#################################################################################################