#################################################################################################
#################################################################################################
############################### ################################# ###############################
####     &       ####                    #+            #                    ####        &    ####
#### ## #### ### #### ##  ### ### ### ##   ### ### ###   ## ### ### ###  ## #### ### #### ## ####
#### ## ###  ##$       ##  ##  ## $##  ###  ##  #$ ##  ###  ##  ##$ ##  ##       $##  ### ## ####
####    ##  ##  ######  ##  ##  ##  ##  ###  ## # ##  ###  ##  ##  ##  ##  ######  ##  ##    ####
#### ####  ##  ##   +##  ##  ##  ##  ##  ###  # # #  ###  ##  ##  ##  ##  ##    ##  ##  #### ####
###  ###  ##  ##  ##  ##  ##  ##  ##  ##  ###   #   ### *##  ##  ##  ##  ##  ##+ ##  ## *###  ###
#### ##  ##$ ##* ####  ##  ##  ##  ##  ##  ### ### ### +## $##  ##  ##$ ##  ####  ##  ##  ## ####
#### #  ##  ##  ######  ##  ##  ##  ##  ##  ##     ##  ##  ##  ##  ##  ##  ######  ##  ## $# ####
####   ##  ##  ##    ##  ##  ##  ##  ##  ##  ### ###  ##  ##  ##  ##  ##  ##    ##  ##  ##   ####
#### #### ### ##  ##  ## ###  ## &##  ##  ## ### ### ##  ##  ##+ ### ### ##  ##  ## ### #### ####
####             ####        #### ### ###               ### ####            ####             ####
#### #### ### ##  ##  ## ###  ##  ##  ##  ## ### ### ##  ##  ##  ### ### ##  ##  ## ### #### ####
####   ##  ##  ##    ##  ##  ##  ##  ##  ##  ### ###  ##  ##  ##  ##  ##  ##   $##  ##  ##   ####
#### # +##  ##  ######  ##  ##  ##  ##  ##  ##     ##  ##  ##  ##  ##  ##  ######  ##  ##  # ####
#### ##  ##  ##$ ####  ##  ##  ## $##  ##  ### ### ###  ##  ##  ##$ ##  ##  ####  ##  ##  ## ####
###  ###  ##  ##  ##  ##  ##  ##  ##  ##  ###   #   ###  ##  ##  ##  ##  ##  ##  ##  ## &###  ###
#### ####  ##  ##   +##  ##  ##  ##  ##  ###  # # #  ###  ##  ## &##  ##  ##+   ##  ##  #### ####
####    ##  ##  ######  ##$ ##  ##  ##  ###  ## # ## $###  ##  ##  ##  ##  ######  ## $##    ####
#### ## ###  ##*     + ##  ##  ##  ## *###  ##  #  ##  ###  ##  ## +##  ##        ##  ### ## ####
#### ## #### ### #### ##  ### ### ### ##   ### ### ###   ## ### ### ###  ## #### ### #### ## ####
####             ####                    # &           #                    ####             ####
############################### ################################# ###############################
#################################################################################################
#################################################################################################